30 40
1-0-2 1-0-1 1-0-0 1-0-1 1-0-1 1-0-2 1-0-2 1-0-1 1-0-2 1-0-1 1-0-0 1-0-1 1-0-1 1-0-0 1-0-0 1-1-0 1-0-2 1-0-0 1-1-0 1-0-1 1-0-1 1-0-1 1-0-0 1-0-0 1-0-1 1-0-1 1-0-1 1-0-2 1-0-1 1-0-2 1-0-1 1-0-0 1-0-1 1-0-0 1-0-1 1-0-0 1-0-0 1-0-2 1-0-2 1-0-1 
1-0-2 1-0-2 1-0-2 1-0-2 1-0-1 1-0-2 1-0-0 1-0-2 1-0-0 1-0-2 1-0-1 1-0-0 1-0-0 1-0-2 1-0-0 1-1-2 1-0-1 1-0-1 1-1-1 1-0-2 1-0-2 1-0-0 1-0-2 1-0-1 1-0-2 1-0-1 1-0-0 1-0-2 1-0-1 1-0-0 1-0-2 1-0-1 1-0-0 1-0-1 1-0-1 1-0-0 1-0-0 1-0-1 1-0-2 1-0-1 
1-0-0 1-0-2 1-0-0 1-0-0 1-0-2 1-0-0 1-0-1 1-0-1 1-0-0 1-0-2 1-0-2 1-0-2 1-0-0 1-0-2 1-0-1 1-1-2 1-2-0 1-3-0 1-1-0 1-0-0 1-0-0 1-0-2 1-0-2 1-0-2 1-0-1 1-0-0 1-0-0 1-0-0 1-0-1 1-0-0 1-0-2 1-0-1 1-0-0 1-0-1 1-0-2 1-0-0 1-0-1 1-0-0 1-0-0 1-0-2 
1-0-1 1-0-1 1-0-0 1-0-1 1-0-0 1-0-1 1-0-1 1-0-1 1-0-1 1-0-1 1-0-0 1-0-2 1-0-0 1-0-0 1-0-0 1-1-2 1-0-2 1-0-0 1-1-0 1-0-2 1-0-2 1-0-0 1-0-1 1-0-1 1-0-0 1-0-2 1-0-0 1-0-2 1-0-2 1-0-0 1-0-2 1-0-1 1-0-1 1-0-0 1-0-1 1-0-2 1-0-2 1-0-0 1-0-1 1-0-2 
1-0-2 1-0-2 1-0-2 1-0-0 1-0-0 1-0-1 1-0-1 1-0-1 1-0-1 1-0-0 1-0-2 1-0-1 1-0-0 1-0-2 1-0-0 1-1-1 1-0-0 1-0-2 1-0-0 1-1-2 1-1-1 1-0-2 1-0-2 1-0-0 1-0-1 1-0-2 1-0-1 1-0-0 1-0-2 1-0-0 1-0-1 1-0-1 1-0-1 1-0-1 1-0-0 1-0-0 1-0-0 1-0-2 1-0-0 1-0-0 
1-0-1 1-0-0 1-0-0 1-0-1 1-0-0 1-0-1 1-0-1 1-0-1 1-0-2 1-0-0 1-0-0 1-0-0 1-0-2 1-1-1 1-1-2 1-0-0 1-0-0 1-0-2 1-0-1 1-1-1 1-0-2 1-1-2 1-0-2 1-1-0 1-0-2 1-0-1 1-0-2 1-0-2 1-0-2 1-0-1 1-0-2 1-0-0 1-0-2 1-0-1 1-0-1 1-0-2 1-0-0 1-0-1 1-0-2 1-0-0 
1-0-2 1-0-0 1-0-2 1-0-1 1-0-0 1-0-2 1-0-1 1-0-2 1-0-2 1-1-0 1-0-1 1-0-1 1-1-1 1-0-1 1-1-1 1-0-2 1-0-0 1-0-2 1-0-2 1-0-2 1-0-1 1-0-2 1-1-1 1-0-0 1-1-1 1-0-1 1-0-0 1-0-2 1-0-0 1-0-2 1-0-0 1-0-0 1-0-1 1-0-1 1-0-1 1-0-0 1-0-0 1-0-0 1-0-2 1-0-1 
1-0-0 1-0-1 1-0-2 1-0-1 1-0-2 1-0-1 1-0-0 1-0-1 1-1-1 1-0-1 1-1-1 1-1-1 1-0-0 1-0-1 1-0-1 1-0-2 1-0-1 1-0-0 1-0-0 1-0-0 1-1-0 1-0-0 1-1-0 1-0-1 1-0-1 1-1-0 1-0-2 1-0-2 1-0-2 1-0-2 1-0-2 1-0-2 1-0-2 1-0-2 1-0-0 1-0-1 1-0-1 1-0-0 1-0-2 1-0-2 
1-0-2 1-0-2 1-0-1 1-0-2 1-0-1 1-0-1 1-0-1 1-1-2 1-1-2 1-0-0 1-0-0 1-0-2 1-0-2 1-1-1 1-0-1 1-0-1 1-0-0 1-0-1 1-0-0 1-0-2 1-0-2 1-0-2 1-0-2 1-0-1 1-1-2 1-0-1 1-1-0 1-0-0 1-1-2 1-1-1 1-1-1 1-0-1 1-0-1 1-0-1 1-0-2 1-0-0 1-0-0 1-0-1 1-0-2 1-0-2 
1-0-0 1-0-1 1-0-1 1-0-0 1-0-0 1-1-1 1-1-0 1-0-0 1-0-2 1-1-2 1-0-1 1-1-2 1-0-0 1-0-0 1-0-2 1-0-2 1-0-2 1-0-1 1-0-0 1-0-1 1-0-2 1-0-0 1-1-2 1-1-2 1-0-0 1-1-2 1-0-0 1-1-1 1-0-1 1-0-1 1-0-2 1-1-2 1-0-2 1-1-0 1-0-2 1-0-1 1-0-2 1-0-2 1-1-2 1-0-0 
1-0-2 1-0-0 1-0-0 1-0-0 1-1-0 1-0-0 1-0-2 1-1-2 1-0-2 1-0-2 1-0-0 1-0-0 1-0-1 1-0-1 1-0-1 1-0-2 1-0-0 1-0-1 1-0-2 1-0-1 1-0-2 1-0-0 1-0-0 1-0-1 1-0-2 1-1-2 1-0-1 1-0-1 1-1-1 1-0-2 1-1-0 1-0-0 1-1-2 1-0-0 1-1-0 1-0-0 1-1-1 1-1-2 1-0-0 1-1-1 
1-0-2 1-0-2 1-0-1 1-1-2 1-0-2 1-1-2 1-0-2 1-0-0 1-0-0 1-1-1 1-0-0 1-0-2 1-0-0 1-0-2 1-0-2 1-0-1 1-0-1 1-0-1 1-0-0 1-0-2 1-0-2 1-0-2 1-0-0 1-0-0 1-0-1 1-0-1 1-1-2 1-0-0 1-0-1 1-0-2 1-0-2 1-1-2 1-0-2 1-0-2 1-0-0 1-1-1 1-0-2 1-0-1 1-0-1 1-1-0 
1-1-2 1-0-2 1-1-0 1-0-0 1-1-1 1-0-2 1-1-0 1-0-0 1-0-1 1-0-1 1-0-0 1-0-0 1-0-1 1-0-2 1-0-0 1-0-0 1-0-0 1-0-1 1-0-0 1-0-0 1-0-1 1-0-1 1-0-2 1-0-0 1-0-0 1-0-1 1-0-1 1-0-1 1-0-1 1-0-1 1-0-0 1-0-0 1-1-2 1-1-0 1-0-1 1-1-1 1-0-2 1-1-1 1-0-2 1-0-0 
1-0-1 1-1-2 1-0-0 1-0-2 1-1-2 1-0-1 1-1-0 1-0-0 1-0-2 1-0-0 1-0-0 1-0-2 1-0-2 1-0-1 1-0-1 1-0-2 1-0-1 1-0-0 1-0-0 1-0-1 1-0-2 1-0-0 1-0-0 1-0-0 1-0-2 1-0-0 1-0-2 1-0-0 1-0-2 1-0-2 1-0-0 1-0-0 1-0-2 1-0-1 1-0-1 1-0-0 1-1-0 1-0-1 1-0-2 1-0-2 
1-0-2 1-0-0 1-0-0 1-1-1 1-0-2 1-1-1 1-0-1 1-0-2 1-0-1 1-0-2 1-0-0 1-0-1 1-0-0 1-0-2 1-0-0 1-0-1 1-0-1 1-0-0 1-0-1 1-0-2 1-0-1 1-0-0 1-0-1 1-0-2 1-0-0 1-0-0 1-0-2 1-0-2 1-0-1 1-0-2 1-0-1 1-0-0 1-0-0 1-0-0 1-0-0 1-0-1 1-0-1 1-0-0 1-0-2 1-0-0 
1-1-0 1-0-2 1-1-2 1-0-1 1-0-0 1-0-1 1-0-1 1-0-2 1-0-2 1-0-1 1-0-0 1-0-1 1-0-2 1-0-0 1-0-0 1-0-1 1-0-0 1-0-0 1-0-2 1-0-0 1-0-2 1-0-1 1-0-2 1-0-2 1-0-1 1-0-0 1-0-0 1-0-1 0-1-1 0-1-1 0-1-0 0-1-0 0-1-2 0-1-1 0-1-1 0-1-0 1-0-0 1-0-2 1-0-2 1-0-0 
1-1-1 1-0-0 1-0-2 1-0-0 1-0-2 1-0-0 1-0-2 1-0-2 1-0-2 1-0-1 1-0-2 1-0-0 1-0-2 1-0-0 1-0-2 1-0-2 1-0-0 1-0-2 1-0-1 1-0-2 1-0-1 1-0-2 1-0-2 1-0-1 1-0-2 1-0-1 1-0-2 1-0-0 0-1-0 0-0-1 0-0-1 0-0-1 0-0-1 0-0-1 0-0-1 0-1-2 1-0-0 1-0-1 1-0-0 1-0-2 
1-1-2 1-0-2 1-0-2 1-0-1 1-0-2 1-0-2 1-0-1 1-0-0 1-0-2 1-0-0 1-0-0 1-0-0 1-0-0 1-0-0 1-0-0 1-0-2 1-0-2 1-0-2 1-0-2 1-0-2 1-0-0 1-0-1 1-0-1 1-0-2 1-0-0 1-0-1 1-0-0 1-0-0 0-1-0 0-0-1 0-0-1 0-0-1 0-0-1 0-0-1 0-0-1 0-1-0 1-0-2 1-0-0 1-0-0 1-0-0 
1-0-0 1-0-2 1-0-1 1-0-2 1-0-2 1-0-1 1-0-0 1-0-0 1-0-2 1-0-0 1-0-1 1-0-0 1-0-2 1-0-0 1-0-1 1-0-1 1-0-1 1-0-2 1-0-1 1-0-2 1-0-0 1-0-0 1-0-1 1-0-2 1-0-2 1-0-1 1-0-1 1-0-1 0-0-0 0-0-1 0-0-1 0-0-1 0-0-1 0-0-1 0-0-1 0-1-1 1-0-2 1-0-2 1-0-0 1-0-1 
1-0-2 1-0-0 1-0-1 1-0-0 1-0-0 1-0-1 1-0-0 1-0-2 1-0-2 1-0-2 1-0-0 1-0-1 1-0-1 1-0-1 1-0-1 1-0-0 1-0-1 1-0-1 1-0-2 1-0-0 1-0-2 1-0-1 1-0-1 1-0-2 1-0-0 1-0-1 1-0-2 1-0-1 0-1-0 0-0-1 0-0-1 0-0-1 0-0-1 0-0-1 0-0-1 0-1-0 1-0-1 1-0-2 1-0-2 1-0-1 
1-0-0 1-0-1 0-1-2 0-1-0 0-1-0 0-1-0 0-1-2 0-1-0 0-1-0 0-1-1 1-0-0 1-0-1 1-0-2 1-0-0 1-0-0 1-0-1 1-0-0 1-0-2 1-0-1 1-0-0 1-0-1 1-0-0 1-0-1 1-0-2 1-0-0 1-0-2 1-0-1 1-0-0 0-1-1 0-0-1 0-0-1 0-0-1 0-0-1 0-0-1 0-0-1 0-1-2 1-0-2 1-0-2 1-0-2 1-0-2 
1-0-0 1-0-1 0-1-2 0-0-2 0-0-1 0-0-2 0-0-1 0-0-2 0-0-2 0-1-2 1-0-0 1-0-0 1-0-0 1-0-1 1-0-2 1-0-0 1-0-2 1-0-0 1-0-2 1-0-2 1-0-0 1-0-0 1-0-2 1-0-1 1-0-1 1-0-2 1-0-0 1-0-0 0-1-2 0-1-1 0-1-2 0-1-0 0-1-0 0-1-1 0-1-0 0-1-0 1-0-1 1-0-2 1-0-2 1-0-2 
1-0-0 1-0-0 0-1-1 0-0-2 0-0-2 0-0-0 0-0-1 0-0-1 0-0-2 0-1-2 1-0-2 1-0-1 1-0-2 1-0-0 1-0-0 1-0-2 1-0-2 1-0-2 1-0-1 1-0-1 1-0-0 1-0-1 1-0-0 1-0-0 1-0-2 1-0-2 1-0-2 1-0-2 1-0-1 1-0-0 1-0-2 1-0-0 1-0-2 1-0-1 1-0-2 1-0-0 1-0-2 1-0-0 1-0-0 1-0-0 
1-0-1 1-0-2 0-1-2 0-0-1 0-0-0 0-0-0 0-0-0 0-0-0 0-0-1 0-0-2 1-0-0 1-0-1 1-0-1 1-0-0 1-0-2 1-0-0 1-0-0 1-0-1 1-0-1 1-0-0 1-0-2 1-0-2 1-0-1 1-0-1 1-0-0 1-0-0 1-0-1 1-0-2 1-0-0 1-0-0 1-0-2 1-0-2 1-0-1 1-0-2 1-0-1 1-0-2 1-0-1 1-0-2 1-0-1 1-0-2 
1-0-2 1-0-2 0-1-2 0-0-1 0-0-1 0-0-2 0-0-0 0-0-2 0-0-0 0-0-2 1-0-1 1-0-0 1-0-1 1-0-2 1-0-2 1-0-2 1-0-2 1-0-1 1-0-2 1-0-1 1-0-2 1-0-2 1-0-1 1-0-0 1-0-2 1-0-1 1-0-2 1-0-0 1-0-1 1-0-1 1-0-0 1-0-1 1-0-2 1-0-2 1-0-0 1-0-2 1-0-0 1-0-1 1-0-1 1-0-2 
1-0-0 1-0-1 0-1-0 0-0-1 0-0-1 0-0-1 0-0-2 0-0-1 0-0-0 0-1-0 1-0-1 1-0-0 1-0-1 1-0-1 1-0-0 1-0-1 1-0-0 1-0-0 1-0-0 1-0-1 1-0-0 1-0-1 1-0-0 1-0-0 1-0-1 1-0-2 1-0-1 1-0-2 1-0-0 1-0-1 1-0-2 1-0-2 1-0-0 1-0-2 1-0-0 1-0-2 1-0-2 1-0-1 1-0-2 1-0-2 
1-0-1 1-0-0 0-1-1 0-0-1 0-0-1 0-0-1 0-0-2 0-0-1 0-0-2 0-1-2 1-0-0 1-0-1 1-0-0 1-0-2 1-0-1 1-0-0 1-0-2 1-0-2 1-0-1 1-0-2 1-0-2 1-0-2 1-0-0 1-0-1 1-0-2 1-0-1 1-0-2 1-0-2 1-0-2 1-0-2 1-0-0 1-0-1 1-0-2 1-0-2 1-0-0 1-0-2 1-0-2 1-0-2 1-0-0 1-0-1 
1-0-0 1-0-1 0-1-1 0-1-0 0-1-0 0-1-2 0-1-0 0-1-0 0-1-1 0-1-2 1-0-2 1-0-2 1-0-2 1-0-2 1-0-1 1-0-2 1-0-1 1-0-0 1-0-2 1-0-0 1-0-1 1-0-0 1-0-2 1-0-1 1-0-1 1-0-2 1-0-0 1-0-0 1-0-0 1-0-2 1-0-0 1-0-1 1-0-2 1-0-0 1-0-1 1-0-1 1-0-0 1-0-0 1-0-0 1-0-0 
1-0-1 1-0-0 1-0-2 1-0-1 1-0-2 1-0-1 1-0-0 1-0-2 1-0-1 1-0-2 1-0-2 1-0-2 1-0-2 1-0-0 1-0-0 1-0-0 1-0-1 1-0-2 1-0-1 1-0-0 1-0-1 1-0-0 1-0-2 1-0-0 1-0-2 1-0-2 1-0-0 1-0-1 1-0-1 1-0-2 1-0-1 1-0-2 1-0-1 1-0-0 1-0-2 1-0-1 1-0-0 1-0-1 1-0-1 1-0-0 
1-0-2 1-0-1 1-0-0 1-0-0 1-0-0 1-0-1 1-0-2 1-0-0 1-0-2 1-0-0 1-0-1 1-0-0 1-0-2 1-0-0 1-0-0 1-0-1 1-0-1 1-0-2 1-0-0 1-0-1 1-0-1 1-0-1 1-0-1 1-0-0 1-0-2 1-0-0 1-0-1 1-0-0 1-0-1 1-0-0 1-0-1 1-0-2 1-0-2 1-0-1 1-0-2 1-0-0 1-0-0 1-0-1 1-0-2 1-0-2 
END
PLAYER SWORDSMAN
PLAYER SWORDSMAN
ENEMY 30 20 0 ARCHER
ENEMY 7 24 0 CIVILIAN
ENEMY 33 17 0 ARCHER
ENEMY 33 18 0 ARCHER
ENEMY 4 26 0 ARCHER
ENEMY 5 22 0 ARCHER
ENEMY 4 25 0 ARCHER
ENEMY 4 22 0 ARCHER
ENEMY 30 19 0 ARCHER
PATROLPATH 14 17 -d 12 25 -t 1 
PATROLPATH 7 21 -d 8 26 -t 1 
PATROLPATH 8 23 -d 7 24 -t 1 
PATROLPATH 33 18 -d 32 16 -t 1 
PATROLPATH 14 26 -d 12 25 -t 1 
PATROLPATH 24 13 -d 27 18 -t 1 
PATROLPATH 4 22 -d 6 26 -t 1 
PATROLPATH 30 18 -d 27 18 -d 30 20 -d 33 18 -d 33 17 -t 1 
PATROLPATH 16 17 -d 23 17 -t 1 
PATROLPATH 23 17 -d 27 18 -t 1 
PATROLPATH 7 24 -d 12 25 -d 5 22 -d 4 25 -d 4 22 -t 1 
PATROLPATH 33 17 -d 34 16 -t 1 
PATROLPATH 32 16 -d 30 18 -t 1 
PATROLPATH 30 19 -d 33 20 -t 1 
PATROLPATH 21 12 -d 14 17 -t 1 
PATROLPATH 33 20 -d 31 16 -t 1 
PATROLPATH 23 25 -d 27 18 -t 1 
PATROLPATH 34 19 -d 30 18 -t 1 
PATROLPATH 30 20 -d 32 18 -t 1 
PATROLPATH 12 25 -d 16 17 -d 16 27 -d 9 16 -d 1 19 -t 1 
PATROLPATH 5 22 -d 8 22 -t 1 
PATROLPATH 9 16 -d 24 13 -t 1 
PATROLPATH 1 19 -d 3 29 -t 1 
PATROLPATH 4 25 -d 7 21 -t 1 
PATROLPATH 20 19 -d 14 26 -t 1 
PATROLPATH 6 26 -d 7 24 -t 1 
PATROLPATH 8 26 -d 7 24 -t 1 
PATROLPATH 34 16 -d 34 19 -t 1 
PATROLPATH 8 22 -d 7 24 -t 1 
PATROLPATH 27 18 -d 30 18 -d 21 12 -d 20 19 -t 1 
PATROLPATH 31 16 -d 30 18 -t 1 
PATROLPATH 32 18 -d 30 18 -t 1 
PATROLPATH 4 26 -d 8 23 -t 1 
PATROLPATH 16 27 -d 23 25 -t 1 
PATROLPATH 3 29 -d 16 27 -t 1 
TRAP 16 1 0 -k 0 
TRAP 28 18 0 -k 0 
TRAP 9 24 0 -k 0 
TRAP 17 1 0 -k 0 
TRAP 9 23 0 -k 0 
