30 40
0-1-1 0-1-2 0-1-2 0-1-2 0-1-0 0-1-1 0-8-2 0-8-1 0-8-2 0-8-0 0-8-1 0-8-2 0-8-2 0-8-1 0-8-0 0-8-0 0-8-1 0-8-2 0-8-0 0-8-1 0-8-1 0-8-0 0-1-2 0-1-0 0-1-1 0-1-0 0-1-0 0-1-1 0-1-1 0-1-2 0-1-2 0-8-0 0-8-2 0-8-1 0-8-1 0-8-2 0-8-1 0-8-1 0-8-2 0-8-2 
0-1-0 0-0-2 0-0-1 0-0-1 0-0-0 0-1-1 0-8-0 0-8-1 0-8-2 0-8-1 0-8-0 0-8-0 0-8-2 0-8-1 0-8-1 0-8-2 0-8-1 0-8-1 0-8-1 0-8-0 0-8-1 0-8-1 0-1-1 0-0-2 0-0-1 0-0-2 0-0-2 0-0-2 0-0-2 0-0-1 0-1-1 0-8-1 0-8-0 0-8-2 0-8-2 0-8-2 0-8-1 0-8-2 0-8-1 0-8-1 
0-1-2 0-0-0 0-0-0 0-0-0 0-0-2 0-1-2 0-8-2 0-8-2 0-8-2 0-8-1 0-8-2 0-8-1 0-8-1 0-8-1 0-8-1 0-8-1 0-8-2 0-8-0 0-8-1 0-8-2 0-8-2 0-8-0 0-1-2 0-0-1 0-0-1 0-0-1 0-0-1 0-0-1 0-0-2 0-0-2 0-1-2 0-8-1 0-8-0 0-8-2 0-8-2 0-8-1 0-8-2 0-8-2 0-8-2 0-8-1 
0-1-1 0-0-0 0-0-1 0-0-0 0-0-2 0-1-1 0-1-1 0-1-0 0-1-2 0-1-0 0-1-1 0-1-1 0-1-1 0-1-0 0-1-2 0-1-1 0-1-2 0-8-0 0-8-0 0-8-0 0-8-2 0-8-0 0-1-2 0-0-2 0-0-2 0-0-1 0-0-0 0-0-1 0-0-0 0-0-0 0-1-1 0-8-1 0-8-2 0-8-0 0-8-0 0-8-1 0-8-0 0-8-1 0-8-1 0-8-2 
0-1-0 0-2-1 0-0-2 0-0-2 0-0-1 0-0-1 0-0-0 0-5-0 0-0-0 0-0-2 0-0-1 0-0-2 0-0-2 0-0-1 0-0-0 0-0-1 0-1-2 0-8-1 0-8-0 0-8-0 0-8-1 0-8-0 0-1-1 0-0-0 0-0-2 0-0-0 0-0-1 0-0-1 0-0-2 0-0-2 0-1-0 0-8-1 0-8-1 0-8-0 0-8-2 0-8-2 0-8-1 0-8-2 0-8-1 0-8-2 
0-1-0 0-1-2 0-1-0 0-1-0 0-1-1 0-1-0 0-1-2 0-1-1 0-1-2 0-1-0 0-1-0 0-1-0 0-1-0 0-1-2 0-1-1 0-0-0 0-1-2 0-8-0 0-8-0 0-8-2 0-8-1 0-8-2 0-1-0 0-0-1 0-0-2 0-0-1 0-0-2 0-0-0 0-0-1 0-0-0 0-1-1 0-8-0 0-8-1 0-8-1 0-8-2 0-8-0 0-8-1 0-8-1 0-8-0 0-8-1 
0-8-0 0-8-1 0-8-2 0-8-1 0-8-0 0-8-2 0-8-0 0-8-0 0-8-1 0-8-2 0-8-2 0-8-2 0-8-2 0-8-0 0-1-1 0-0-2 0-1-0 0-8-0 0-8-1 0-8-2 0-8-2 0-8-1 0-1-2 0-1-0 0-1-2 0-1-0 0-0-2 0-1-2 0-1-0 0-1-2 0-1-2 0-8-1 0-1-1 0-1-2 0-1-0 0-1-2 0-1-2 0-8-2 0-8-1 0-8-1 
0-8-1 0-1-2 0-1-0 0-1-1 0-1-1 0-8-1 0-8-0 0-8-2 0-8-2 0-8-2 0-8-1 0-1-2 0-1-0 0-1-0 0-1-0 0-0-2 0-1-0 0-1-2 0-1-2 0-1-0 0-8-2 0-8-2 0-8-1 0-8-2 0-8-1 0-1-0 0-0-2 0-1-2 0-8-1 0-8-2 0-8-2 0-8-2 0-1-1 0-0-0 0-0-1 0-0-1 0-1-0 0-8-2 0-8-1 0-8-1 
0-8-1 0-1-0 0-0-0 0-0-0 0-1-2 0-1-2 0-1-1 0-1-2 0-1-1 0-1-2 0-1-2 0-1-2 0-0-0 0-0-0 0-0-1 0-0-0 0-0-0 0-0-0 0-0-2 0-1-1 0-1-0 0-1-1 0-1-2 0-1-2 0-1-2 0-1-2 0-0-2 0-1-2 0-1-0 0-1-0 0-1-1 0-1-0 0-1-1 0-0-1 0-0-1 0-0-2 0-1-2 0-8-0 0-8-0 0-8-1 
0-8-0 0-1-0 0-0-2 0-0-0 0-0-0 0-0-1 0-0-0 0-0-0 0-0-0 0-0-0 0-0-2 0-0-0 0-0-1 0-0-2 0-0-1 0-0-2 0-0-0 0-0-2 0-0-2 0-0-1 0-0-0 0-0-1 0-0-1 0-0-0 0-0-1 0-0-0 0-0-2 0-0-1 0-0-2 0-0-1 0-0-0 0-0-1 0-0-2 0-0-2 0-0-0 0-0-0 0-1-1 0-8-2 0-8-1 0-8-0 
0-8-1 0-1-0 0-0-0 0-0-0 0-0-1 0-0-1 0-0-2 0-0-0 0-0-0 0-0-0 0-0-1 0-0-2 0-0-0 0-0-2 0-0-2 0-0-0 0-0-1 0-0-2 0-0-2 0-1-0 0-1-0 0-1-1 0-1-1 0-1-0 0-1-1 0-1-2 0-0-0 0-1-2 0-0-2 0-0-1 0-1-2 0-1-0 0-1-0 0-0-0 0-0-2 0-0-0 0-1-2 0-8-2 0-8-1 0-8-2 
0-8-0 0-1-1 0-0-1 0-0-1 0-1-2 0-1-2 0-1-0 0-1-1 0-1-1 0-1-1 0-1-1 0-1-1 0-0-1 0-0-0 0-0-0 0-0-2 0-0-1 0-0-2 0-0-0 0-1-1 0-8-0 0-8-1 0-8-2 0-8-1 0-8-2 0-1-2 0-0-0 0-1-2 0-0-1 0-0-1 0-1-2 0-8-2 0-1-1 0-0-2 0-0-1 0-0-2 0-1-1 0-8-1 0-8-0 0-8-2 
0-8-2 0-1-2 0-1-2 0-1-2 0-1-1 0-1-0 0-1-1 0-1-2 0-1-2 0-1-0 0-1-0 0-1-0 0-0-1 0-0-1 0-0-0 0-0-1 0-0-2 0-0-0 0-0-0 0-1-1 0-8-2 0-8-0 0-8-2 0-8-2 0-8-1 0-1-1 0-0-2 0-1-2 0-0-0 0-0-0 0-1-1 0-8-2 0-1-1 0-1-0 0-1-0 0-1-1 0-1-0 0-8-0 0-8-1 0-8-2 
0-8-1 0-8-1 0-8-1 0-1-0 0-0-2 0-0-0 0-0-1 0-0-2 0-0-1 0-0-1 0-0-2 0-0-1 0-0-2 0-0-1 0-0-2 0-0-2 0-0-0 0-0-0 0-0-2 0-1-2 0-8-2 0-8-2 0-8-2 0-8-2 0-8-2 0-1-2 0-0-2 0-1-0 0-0-0 0-0-1 0-1-2 0-8-1 0-8-0 0-8-1 0-8-1 0-8-0 0-8-2 0-8-1 0-8-0 0-8-1 
0-8-2 0-8-2 0-8-2 0-1-1 0-0-2 0-0-2 0-1-0 0-0-1 0-1-2 0-1-1 0-1-2 0-1-0 0-0-2 0-1-0 0-1-1 0-1-0 0-1-0 0-1-1 0-1-1 0-1-0 0-1-0 0-1-2 0-1-1 0-1-0 0-1-0 0-1-0 0-0-1 0-1-0 0-0-0 0-0-0 0-1-0 0-8-1 0-8-1 0-8-1 0-8-0 0-8-2 0-8-2 0-8-0 0-8-2 0-8-1 
0-8-1 0-8-0 0-8-2 0-1-0 0-0-2 0-0-2 0-1-1 0-0-1 0-1-2 0-0-1 0-0-2 0-0-1 0-0-1 0-1-2 0-8-1 0-8-1 0-1-2 0-0-2 0-0-1 0-0-2 0-0-0 0-0-1 0-0-0 0-0-1 0-0-1 0-0-1 0-0-1 0-1-1 0-0-2 0-0-0 0-1-0 0-8-0 0-8-1 0-8-1 0-8-0 0-8-1 0-8-0 0-8-2 0-8-1 0-8-2 
0-1-0 0-1-1 0-1-0 0-1-0 0-0-0 0-0-2 0-1-0 0-0-2 0-1-2 0-0-2 0-0-1 0-1-2 0-0-1 0-1-1 0-8-2 0-8-1 0-1-2 0-0-1 0-1-0 0-1-1 0-1-2 0-1-0 0-1-2 0-1-0 0-1-2 0-1-1 0-1-2 0-1-2 0-0-2 0-0-2 0-1-2 0-1-1 0-1-0 0-8-1 0-8-2 0-8-1 0-8-0 0-8-0 0-8-0 0-8-1 
0-1-2 0-0-1 0-0-1 0-1-1 0-0-1 0-0-2 0-1-1 0-0-2 0-1-1 0-0-0 0-0-2 0-1-0 0-0-1 0-1-0 0-8-2 0-8-2 0-1-1 0-0-2 0-1-0 0-8-2 0-8-0 0-8-0 0-8-2 0-8-0 0-8-1 0-1-0 0-0-2 0-0-0 0-0-1 0-0-1 0-0-0 0-0-2 0-1-2 0-8-2 0-8-2 0-8-1 0-8-2 0-8-2 0-8-2 0-8-1 
0-1-1 0-0-0 0-0-2 0-0-1 0-0-2 0-0-2 0-1-2 0-5-0 0-1-2 0-0-1 0-0-2 0-1-0 0-0-0 0-1-1 0-8-2 0-8-1 0-1-1 0-0-2 0-1-1 0-8-1 0-8-1 0-8-0 0-8-0 0-8-0 0-8-2 0-1-1 0-0-1 0-0-1 0-0-1 0-0-2 0-0-0 0-0-0 0-1-2 0-8-1 0-8-2 0-8-1 0-8-0 0-8-1 0-8-2 0-8-2 
0-1-2 0-0-2 0-0-1 0-1-0 0-0-1 0-0-0 0-1-1 0-1-1 0-1-2 0-0-2 0-0-1 0-1-1 0-0-0 0-1-2 0-8-1 0-8-2 0-1-1 0-0-0 0-1-0 0-8-2 0-8-2 0-8-0 0-8-2 0-8-0 0-8-1 0-1-1 0-0-2 0-0-0 0-0-1 0-0-2 0-0-2 0-0-0 0-1-0 0-8-2 0-8-0 0-8-0 0-8-2 0-8-1 0-8-0 0-8-1 
0-1-2 0-1-0 0-1-0 0-1-2 0-0-0 0-0-0 0-0-1 0-0-2 0-0-0 0-0-1 0-0-1 0-1-2 0-0-2 0-1-2 0-8-2 0-8-2 0-1-0 0-0-0 0-1-1 0-8-1 0-8-1 0-8-2 0-8-0 0-8-1 0-8-1 0-1-1 0-0-0 0-0-0 0-0-2 0-0-0 0-0-0 0-0-1 0-1-1 0-8-1 0-8-0 0-8-2 0-8-2 0-8-2 0-8-2 0-8-2 
0-8-1 0-8-1 0-8-1 0-1-0 0-0-1 0-0-1 0-0-1 0-0-0 0-0-2 0-0-2 0-0-0 0-1-0 0-0-2 0-1-2 0-8-1 0-8-1 0-1-1 0-0-0 0-1-2 0-8-0 0-8-0 0-8-0 0-8-0 0-8-0 0-8-2 0-1-2 0-0-2 0-0-0 0-0-2 0-0-0 0-0-2 0-0-2 0-1-1 0-8-2 0-8-1 0-8-1 0-8-0 0-8-1 0-8-2 0-8-0 
0-8-1 0-8-0 0-1-1 0-1-0 0-1-2 0-1-2 0-1-2 0-1-1 0-1-0 0-1-2 0-1-1 0-1-0 0-0-2 0-1-0 0-1-1 0-1-0 0-1-0 0-0-0 0-1-0 0-8-0 0-8-1 0-8-2 0-8-2 0-8-1 0-8-0 0-1-2 0-0-2 0-0-0 0-0-0 0-0-0 0-0-1 0-0-1 0-1-0 0-8-1 0-8-0 0-8-0 0-8-1 0-8-1 0-8-0 0-8-2 
0-8-1 0-8-2 0-1-0 0-0-0 0-0-2 0-0-0 0-0-1 0-0-2 0-0-0 0-0-0 0-0-0 0-0-1 0-0-0 0-0-0 0-0-0 0-0-2 0-0-0 0-0-2 0-1-1 0-8-2 0-8-0 0-8-2 0-8-1 0-8-1 0-8-1 0-1-2 0-0-0 0-0-2 0-0-2 0-0-0 0-0-0 0-0-1 0-1-1 0-8-1 0-8-0 0-8-2 0-8-2 0-8-1 0-8-2 0-8-1 
0-8-2 0-8-0 0-1-2 0-0-2 0-0-1 0-0-0 0-0-0 0-0-1 0-0-2 0-0-2 0-0-2 0-0-2 0-0-0 0-1-2 0-1-0 0-1-0 0-1-2 0-0-0 0-1-1 0-8-2 0-8-0 0-8-1 0-8-1 0-8-1 0-8-0 0-1-1 0-0-2 0-0-0 0-0-2 0-0-0 0-0-0 0-0-0 0-1-0 0-8-1 0-8-2 0-8-1 0-8-2 0-8-0 0-8-2 0-8-2 
0-8-0 0-8-1 0-1-1 0-0-2 0-0-0 0-0-2 0-0-0 0-0-0 0-0-2 0-0-2 0-0-1 0-0-1 0-0-2 0-1-1 0-1-2 0-1-1 0-1-2 0-0-0 0-1-2 0-1-2 0-1-2 0-8-2 0-8-2 0-8-0 0-8-2 0-1-1 0-0-1 0-0-2 0-0-0 0-0-1 0-0-1 0-0-2 0-1-1 0-8-2 0-8-0 0-8-2 0-8-0 0-8-2 0-8-0 0-8-2 
0-8-1 0-8-2 0-1-2 0-0-0 0-0-1 0-0-2 0-0-2 0-0-0 0-0-2 0-0-1 0-0-0 0-0-1 0-0-0 0-1-0 0-1-0 0-0-0 0-0-0 0-0-0 0-0-0 0-0-1 0-1-0 0-8-2 0-8-1 0-8-2 0-8-0 0-1-1 0-0-2 0-0-2 0-0-0 0-0-1 0-0-1 0-0-1 0-1-0 0-8-0 0-8-1 0-8-2 0-8-2 0-8-2 0-8-2 0-8-1 
0-8-1 0-8-1 0-1-1 0-0-0 0-0-1 0-0-2 0-0-0 0-0-1 0-0-2 0-0-1 0-0-0 0-0-0 0-0-1 0-1-1 0-1-2 0-0-2 0-0-2 0-0-1 0-0-0 0-0-2 0-1-2 0-8-0 0-8-1 0-8-2 0-8-0 0-1-1 0-1-2 0-1-0 0-0-2 0-0-0 0-1-1 0-1-0 0-1-0 0-8-1 0-8-2 0-8-2 0-8-0 0-8-1 0-8-0 0-8-1 
0-8-1 0-8-2 0-1-2 0-0-2 0-0-2 0-0-0 0-0-1 0-0-1 0-0-0 0-0-1 0-0-2 0-0-0 0-0-2 0-1-1 0-1-1 0-0-0 0-0-2 0-0-0 0-0-1 0-0-0 0-1-1 0-8-1 0-8-1 0-8-1 0-8-2 0-8-2 0-8-2 0-1-2 0-0-0 0-0-2 0-1-2 0-8-0 0-8-0 0-8-0 0-8-1 0-8-2 0-8-2 0-8-2 0-8-2 0-8-1 
0-8-1 0-8-0 0-1-1 0-1-0 0-1-0 0-1-0 0-1-1 0-1-0 0-1-0 0-1-1 0-1-1 0-1-2 0-1-0 0-1-0 0-1-1 0-1-0 0-1-0 0-1-1 0-1-0 0-1-0 0-1-1 0-8-1 0-8-2 0-8-2 0-8-0 0-8-0 0-8-1 0-1-2 0-4-1 0-4-1 0-1-0 0-8-2 0-8-0 0-8-1 0-8-2 0-8-1 0-8-1 0-8-2 0-8-2 0-8-1 
END
PLAYER SWORDSMAN
ENEMY 3 24 0 CIVILIAN
ENEMY 28 4 0 CIVILIAN
ENEMY 3 23 0 CIVILIAN
ENEMY 6 23 0 CIVILIAN
ENEMY 28 22 0 ARCHER
ENEMY 4 16 0 ARCHER
ENEMY 6 27 0 CIVILIAN
ENEMY 27 4 0 CIVILIAN
ENEMY 24 2 0 CIVILIAN
ENEMY 6 28 0 CIVILIAN
ENEMY 25 2 0 CIVILIAN
ENEMY 3 28 0 CIVILIAN
ENEMY 4 20 0 ARCHER
ENEMY 3 27 0 CIVILIAN
ENEMY 6 24 0 CIVILIAN
PATROLPATH 3 24 -t 100 -a 270 
PATROLPATH 28 4 -t 100 -a 180 
PATROLPATH 6 28 -t 100 -a 270 
PATROLPATH 28 22 -t 100 -a 270 
PATROLPATH 4 16 -d 4 20 -t 100 -a 270 
PATROLPATH 6 27 -t 100 -a 90 
PATROLPATH 27 4 -t 100 -a 0 
PATROLPATH 3 28 -t 100 -a 270 
PATROLPATH 24 2 -t 100 -a 0 
PATROLPATH 3 23 -t 100 -a 90 
PATROLPATH 25 2 -t 100 -a 180 
PATROLPATH 6 23 -t 100 -a 90 
PATROLPATH 4 20 -d 4 16 -t 100 -a 0 
PATROLPATH 3 27 -t 100 -a 90 
PATROLPATH 6 24 -t 100 -a 270 
TRAPTRIGGER 17 6 -d 17 6 -d 17 6 -d 17 6 -d 17 6 -d 17 6 -d 17 6 -d 17 6 -d 12 16 -d 12 19 -t 1 
TRAPTRIGGER 15 2 -d 15 2 -d 15 2 -d 15 2 -d 15 2 -d 15 2 -d 15 2 -d 15 2 -d 15 2 -d 15 2 -d 15 2 -d 15 2 -d 15 2 -d 15 2 -d 15 2 -d 15 2 -d 15 2 -d 15 6 -d 11 9 -d 11 10 -d 8 9 -d 8 10 -d 5 9 -d 5 10 -t 1 
TRAPTRIGGER 19 6 -d 19 6 -d 19 6 -d 19 6 -d 19 6 -d 19 6 -d 19 6 -d 19 6 -d 12 18 -d 12 21 -t 1 
TRAPTRIGGER 19 17 -d 19 17 -d 19 17 -d 19 17 -d 19 17 -d 19 17 -d 19 17 -d 17 16 -t 1 
TRAPTRIGGER 7 18 -d 7 18 -d 7 18 -d 7 18 -d 7 18 -d 7 18 -d 7 18 -d 7 18 -d 5 18 -d 4 18 -d 5 19 -d 4 19 -d 5 17 -d 4 17 -t 1 
TRAPTRIGGER 18 6 -d 18 6 -d 18 6 -d 18 6 -d 18 6 -d 18 6 -d 18 6 -d 18 6 -d 12 17 -d 12 20 -t 1 
TRAPTRIGGER 19 22 -d 19 22 -d 19 22 -d 19 22 -d 19 22 -d 19 22 -d 19 22 -d 17 22 -t 1 
TRAPTRIGGER 19 19 -d 19 19 -d 19 19 -d 19 19 -d 19 19 -d 19 19 -d 19 19 -d 17 19 -t 1 
TRAP 5 9 3  
TRAP 19 19 4 -t 60 
TRAP 4 10 0 -k 3 
TRAP 4 18 3  
TRAP 5 19 3  
TRAP 8 9 3  
TRAP 19 22 4 -t 60 
TRAP 12 16 2  
TRAP 17 16 3  
TRAP 11 10 3  
TRAP 12 20 2  
TRAP 4 9 0 -k 3 
TRAP 4 19 3  
TRAP 5 18 3  
TRAP 8 10 3  
TRAP 12 17 2  
TRAP 12 21 2  
TRAP 6 4 0 -k 4 
TRAP 17 19 3  
TRAP 19 6 4 -t 80 
TRAP 5 17 3  
TRAP 11 9 3  
TRAP 12 18 2  
TRAP 18 6 4 -t 80 
TRAP 17 22 3  
TRAP 17 6 4 -t 80 
TRAP 27 9 0 -k 3 
TRAP 5 10 3  
TRAP 15 2 4 -t 40 
TRAP 19 17 4 -t 70 
TRAP 4 17 3  
TRAP 12 19 2  
TRAP 15 6 2  
TRAP 26 10 0 -k 3 
ITEM 2 8 5
ITEM 3 11 5
ITEM 16 28 5
ITEM 35 8 5
ITEM 33 8 5
ITEM 26 11 3
ITEM 25 1 5
ITEM 1 18 3
ITEM 2 9 5
ITEM 3 10 5
ITEM 4 1 4
ITEM 27 1 5
ITEM 34 9 6
ITEM 35 10 5
ITEM 2 10 5
ITEM 3 9 5
ITEM 16 26 5
ITEM 33 10 5
ITEM 17 27 6
ITEM 26 1 5
ITEM 2 11 5
ITEM 3 8 5
ITEM 18 26 5
ITEM 18 28 5
