30 40
0-1-0 0-1-0 0-1-1 0-1-1 0-8-1 0-8-1 0-8-1 0-1-2 0-1-1 0-1-0 0-1-1 0-1-1 0-1-0 0-1-0 0-1-0 0-1-1 0-1-0 0-1-1 0-1-1 0-1-2 0-0-2 0-0-0 0-1-1 0-1-2 0-1-1 0-1-0 0-1-2 0-1-1 0-1-1 0-1-2 0-1-1 0-1-1 0-1-1 0-1-0 0-8-0 0-8-0 0-1-2 0-1-2 0-1-0 0-1-0 
0-1-0 0-0-1 0-3-0 0-1-2 0-8-1 0-8-1 0-8-1 0-1-2 0-0-1 0-0-0 0-0-2 0-0-2 0-0-2 0-0-1 0-0-1 0-0-2 0-0-0 0-0-2 0-0-1 0-0-1 0-2-1 0-0-2 0-0-1 0-0-2 0-0-2 0-0-1 0-0-2 0-0-0 0-0-1 0-0-2 0-0-2 0-0-1 0-0-1 0-1-1 0-8-2 0-8-2 0-1-2 0-4-1 0-4-2 0-1-1 
0-1-1 0-0-0 0-0-1 0-1-0 0-8-1 0-8-0 0-8-2 0-1-1 0-0-1 0-0-1 0-0-0 0-0-0 0-0-1 0-0-2 0-0-2 0-0-1 0-0-0 0-0-2 0-0-1 0-0-1 0-0-0 0-0-0 0-0-2 0-0-2 0-0-1 0-0-2 0-0-2 0-0-1 0-0-2 0-0-0 0-0-2 0-0-1 0-0-2 0-1-1 0-8-0 0-8-1 0-1-0 0-0-0 0-0-2 0-1-0 
0-1-0 0-0-2 0-0-1 0-1-1 0-1-2 0-1-2 0-1-0 0-1-1 0-0-1 0-0-2 0-1-2 0-1-2 0-1-2 0-1-0 0-1-2 0-1-0 0-1-0 0-1-0 0-1-2 0-1-0 0-1-1 0-1-2 0-1-1 0-1-1 0-1-2 0-1-2 0-1-1 0-1-2 0-1-1 0-1-1 0-1-0 0-0-0 0-0-0 0-1-0 0-8-1 0-8-1 0-1-2 0-0-2 0-0-0 0-1-2 
0-1-1 0-0-1 0-0-1 0-0-0 0-0-1 0-0-2 0-0-1 0-0-2 0-0-1 0-0-1 0-0-2 0-0-2 0-0-0 0-0-0 0-0-1 0-0-0 0-0-0 0-0-2 0-0-2 0-1-1 0-8-2 0-8-0 0-1-1 0-0-0 0-0-2 0-0-2 0-0-2 0-0-0 0-0-2 0-0-1 0-0-0 0-0-0 0-0-1 0-1-1 0-8-2 0-8-1 0-1-1 0-0-1 0-0-2 0-1-2 
0-1-2 0-0-0 0-0-2 0-0-0 0-0-2 0-0-2 0-0-2 0-0-1 0-0-2 0-0-1 0-0-0 0-0-0 0-0-1 0-0-2 0-0-1 0-0-1 0-0-0 0-0-2 0-0-1 0-1-1 0-8-1 0-8-2 0-1-0 0-0-1 0-0-1 0-0-1 0-0-2 0-0-1 0-0-1 0-0-1 0-0-1 0-0-1 0-0-2 0-1-2 0-8-2 0-8-1 0-1-1 0-0-1 0-0-2 0-1-1 
0-1-0 0-0-1 0-0-0 0-1-2 0-1-1 0-1-2 0-1-2 0-1-2 0-0-0 0-0-2 0-1-1 0-1-2 0-1-0 0-1-2 0-1-1 0-1-0 0-1-2 0-0-2 0-0-0 0-1-2 0-8-2 0-8-2 0-1-1 0-0-1 0-0-0 0-1-0 0-1-1 0-1-2 0-1-1 0-1-2 0-1-0 0-1-0 0-1-2 0-1-1 0-8-1 0-8-0 0-1-1 0-0-0 0-0-1 0-1-0 
0-1-0 0-0-1 0-0-0 0-1-2 0-8-2 0-8-2 0-8-1 0-1-1 0-0-1 0-0-1 0-1-0 0-1-2 0-1-2 0-1-0 0-1-0 0-1-2 0-1-0 0-0-1 0-0-0 0-1-1 0-8-1 0-8-0 0-1-0 0-0-0 0-0-1 0-1-2 0-1-1 0-1-1 0-1-2 0-1-0 0-1-0 0-1-0 0-1-0 0-1-0 0-8-1 0-8-0 0-1-2 0-0-2 0-0-1 0-1-2 
0-1-1 0-0-2 0-0-0 0-1-0 0-8-2 0-8-0 0-8-2 0-1-0 0-0-0 0-0-1 0-0-1 0-0-2 0-0-1 0-0-0 0-0-1 0-0-1 0-1-1 0-0-0 0-0-0 0-1-0 0-8-1 0-8-2 0-1-2 0-0-2 0-0-0 0-0-0 0-0-2 0-0-0 0-0-1 0-0-2 0-0-2 0-0-0 0-0-0 0-1-2 0-8-2 0-8-2 0-1-0 0-0-2 0-0-0 0-1-2 
0-1-2 0-0-2 0-0-1 0-1-1 0-8-0 0-8-0 0-8-0 0-1-1 0-0-0 0-0-0 0-0-1 0-0-1 0-0-1 0-0-1 0-0-1 0-0-0 0-1-0 0-0-1 0-0-0 0-1-1 0-8-0 0-8-1 0-1-1 0-0-1 0-0-2 0-0-2 0-0-2 0-0-1 0-0-0 0-0-1 0-0-2 0-0-2 0-0-1 0-1-2 0-8-0 0-8-0 0-1-1 0-0-2 0-0-0 0-1-0 
0-1-1 0-0-1 0-0-1 0-1-2 0-8-2 0-8-0 0-8-0 0-1-1 0-0-0 0-0-0 0-1-2 0-1-0 0-1-0 0-1-1 0-0-0 0-0-1 0-1-1 0-0-0 0-0-0 0-1-2 0-8-0 0-8-2 0-1-2 0-0-1 0-0-0 0-1-2 0-1-0 0-1-0 0-1-1 0-1-2 0-1-1 0-0-2 0-0-2 0-1-0 0-8-2 0-8-0 0-1-2 0-0-1 0-0-0 0-1-0 
0-1-0 0-0-2 0-0-0 0-1-1 0-8-2 0-8-0 0-8-1 0-1-2 0-0-1 0-0-0 0-1-1 0-8-2 0-8-1 0-1-0 0-0-0 0-0-0 0-1-1 0-0-1 0-0-2 0-1-1 0-8-2 0-8-0 0-1-1 0-0-2 0-0-1 0-1-0 0-0-1 0-0-1 0-0-1 0-0-2 0-0-0 0-0-2 0-0-0 0-1-0 0-8-2 0-8-1 0-1-0 0-0-2 0-0-1 0-1-0 
0-1-2 0-0-1 0-0-2 0-1-2 0-8-1 0-8-0 0-8-0 0-1-1 0-0-0 0-0-0 0-1-0 0-8-2 0-8-2 0-1-1 0-0-2 0-0-2 0-1-0 0-0-2 0-0-0 0-1-0 0-1-1 0-1-0 0-1-0 0-0-2 0-0-2 0-1-0 0-0-1 0-0-2 0-0-2 0-0-2 0-0-1 0-0-1 0-0-1 0-1-0 0-8-1 0-8-2 0-1-1 0-0-0 0-0-1 0-1-2 
0-1-0 0-0-0 0-0-2 0-1-2 0-8-0 0-8-0 0-8-0 0-1-2 0-0-1 0-0-1 0-1-2 0-8-0 0-8-1 0-1-2 0-0-1 0-0-1 0-1-0 0-0-1 0-0-1 0-0-0 0-0-1 0-0-1 0-0-2 0-0-0 0-0-1 0-1-2 0-0-2 0-0-1 0-1-0 0-1-1 0-1-1 0-1-0 0-1-0 0-1-2 0-1-1 0-1-2 0-1-0 0-0-1 0-0-0 0-1-1 
0-1-0 0-0-1 0-0-1 0-1-2 0-8-2 0-8-0 0-8-1 0-1-1 0-0-1 0-0-1 0-1-1 0-8-2 0-8-2 0-1-1 0-0-2 0-0-0 0-1-1 0-0-1 0-0-1 0-0-1 0-0-2 0-0-2 0-0-0 0-0-0 0-0-1 0-1-2 0-0-0 0-0-1 0-1-1 0-8-2 0-8-2 0-1-1 0-0-1 0-0-0 0-0-0 0-0-1 0-0-0 0-0-0 0-0-1 0-1-1 
0-1-1 0-0-1 0-0-1 0-1-1 0-8-1 0-8-0 0-8-0 0-1-2 0-0-2 0-0-1 0-1-1 0-8-0 0-8-0 0-1-1 0-0-0 0-0-0 0-1-1 0-1-1 0-0-2 0-0-0 0-0-0 0-0-1 0-0-0 0-0-2 0-1-0 0-1-1 0-0-1 0-0-2 0-1-1 0-8-1 0-8-1 0-1-0 0-0-0 0-0-1 0-0-1 0-0-1 0-0-2 0-0-0 0-0-0 0-1-2 
0-1-1 0-0-0 0-0-2 0-1-2 0-8-0 0-8-0 0-8-1 0-1-0 0-0-1 0-0-1 0-1-0 0-8-1 0-8-1 0-1-0 0-0-1 0-0-1 0-1-1 0-1-1 0-0-2 0-0-2 0-0-1 0-0-0 0-0-1 0-0-0 0-1-1 0-1-1 0-0-0 0-0-2 0-1-1 0-8-2 0-8-1 0-1-0 0-0-0 0-0-0 0-1-0 0-1-0 0-1-2 0-0-1 0-0-0 0-1-0 
0-1-1 0-0-2 0-0-1 0-1-0 0-8-0 0-8-1 0-8-2 0-1-2 0-0-1 0-0-0 0-1-1 0-8-2 0-8-1 0-1-0 0-0-1 0-0-0 0-1-0 0-1-1 0-0-2 0-0-1 0-0-1 0-0-0 0-0-0 0-0-2 0-1-1 0-1-2 0-0-0 0-0-2 0-1-0 0-8-0 0-8-0 0-1-0 0-0-2 0-0-0 0-1-1 0-8-1 0-1-0 0-0-2 0-0-2 0-1-0 
0-1-0 0-0-2 0-0-1 0-1-2 0-1-0 0-1-1 0-1-2 0-1-2 0-0-1 0-0-1 0-1-2 0-1-0 0-1-2 0-1-2 0-0-1 0-0-1 0-1-1 0-1-2 0-3-1 0-0-1 0-0-2 0-0-2 0-0-0 0-0-0 0-1-1 0-1-2 0-0-1 0-0-2 0-1-1 0-8-0 0-8-2 0-1-2 0-0-1 0-0-1 0-1-2 0-8-1 0-1-1 0-0-1 0-0-2 0-1-0 
0-1-0 0-0-0 0-0-1 0-0-1 0-0-0 0-0-1 0-0-0 0-0-0 0-0-0 0-0-1 0-0-1 0-0-2 0-0-0 0-0-2 0-0-0 0-0-0 0-1-1 0-1-2 0-1-0 0-1-0 0-1-0 0-1-0 0-0-0 0-0-1 0-1-2 0-1-1 0-0-1 0-0-1 0-1-2 0-1-1 0-1-2 0-1-2 0-0-1 0-0-1 0-1-1 0-8-0 0-1-2 0-0-1 0-0-2 0-1-1 
0-1-1 0-0-2 0-0-2 0-0-1 0-0-2 0-0-1 0-0-0 0-0-2 0-0-0 0-0-1 0-0-0 0-0-2 0-0-1 0-0-2 0-0-2 0-0-0 0-1-1 0-8-1 0-8-1 0-8-1 0-8-0 0-1-0 0-0-2 0-0-1 0-0-2 0-0-0 0-0-2 0-0-2 0-0-2 0-0-2 0-0-1 0-0-2 0-0-1 0-0-1 0-1-1 0-8-1 0-1-0 0-0-1 0-0-0 0-1-0 
0-1-1 0-0-2 0-0-1 0-1-0 0-1-2 0-1-0 0-1-1 0-1-0 0-0-0 0-0-1 0-1-2 0-1-2 0-1-2 0-1-0 0-1-2 0-1-1 0-1-1 0-1-2 0-1-0 0-1-2 0-1-2 0-1-2 0-0-1 0-0-0 0-0-1 0-0-2 0-0-2 0-0-2 0-0-2 0-0-0 0-0-0 0-0-2 0-0-2 0-0-0 0-1-0 0-8-1 0-1-1 0-0-2 0-0-2 0-1-1 
0-1-0 0-0-0 0-0-0 0-1-2 0-8-0 0-8-2 0-8-2 0-1-2 0-0-1 0-0-0 0-0-1 0-0-1 0-0-0 0-0-1 0-0-2 0-0-2 0-0-0 0-0-0 0-0-2 0-0-1 0-0-2 0-0-2 0-0-0 0-0-0 0-1-0 0-1-1 0-1-1 0-1-1 0-1-0 0-1-1 0-1-2 0-1-1 0-0-0 0-0-1 0-1-2 0-8-2 0-1-0 0-0-2 0-0-1 0-1-0 
0-1-1 0-0-2 0-0-0 0-1-2 0-8-2 0-8-1 0-8-2 0-1-2 0-0-2 0-0-1 0-0-1 0-0-0 0-0-1 0-0-2 0-0-1 0-0-0 0-0-2 0-0-1 0-0-2 0-0-2 0-0-0 0-0-1 0-0-1 0-0-2 0-1-1 0-8-0 0-8-1 0-8-1 0-8-2 0-8-2 0-8-2 0-1-2 0-0-0 0-0-0 0-1-1 0-8-1 0-1-1 0-0-0 0-0-2 0-1-2 
0-1-0 0-0-1 0-0-2 0-1-1 0-8-0 0-8-1 0-8-1 0-1-1 0-0-2 0-0-2 0-1-2 0-1-0 0-1-0 0-1-2 0-1-1 0-1-0 0-1-2 0-1-1 0-0-0 0-0-2 0-1-0 0-1-1 0-1-1 0-1-0 0-1-1 0-8-1 0-8-1 0-8-2 0-8-2 0-8-2 0-8-2 0-1-1 0-0-1 0-0-0 0-1-0 0-8-2 0-1-0 0-0-0 0-0-2 0-1-0 
0-1-2 0-0-1 0-0-2 0-1-2 0-8-1 0-8-2 0-8-1 0-1-0 0-0-1 0-0-1 0-1-2 0-8-0 0-8-0 0-8-1 0-8-0 0-8-2 0-8-1 0-1-0 0-0-1 0-0-0 0-1-0 0-8-0 0-8-0 0-8-0 0-8-2 0-8-0 0-8-2 0-8-1 0-8-0 0-8-0 0-8-1 0-1-2 0-0-0 0-0-0 0-1-2 0-8-1 0-1-1 0-0-1 0-0-1 0-1-2 
0-1-0 0-0-2 0-0-2 0-1-2 0-1-2 0-1-0 0-1-0 0-1-1 0-0-2 0-0-1 0-1-0 0-1-1 0-1-1 0-1-0 0-1-1 0-1-0 0-1-0 0-1-2 0-0-0 0-0-0 0-1-1 0-1-0 0-1-2 0-1-2 0-1-0 0-1-1 0-1-0 0-1-1 0-1-0 0-1-1 0-1-1 0-1-1 0-0-0 0-0-1 0-1-2 0-1-0 0-1-2 0-0-2 0-0-2 0-1-0 
0-1-2 0-0-2 0-0-0 0-0-1 0-0-1 0-0-0 0-0-2 0-0-0 0-0-1 0-0-0 0-0-2 0-0-0 0-0-0 0-0-0 0-0-1 0-0-1 0-0-0 0-0-1 0-0-0 0-0-2 0-0-0 0-0-1 0-0-1 0-0-1 0-0-0 0-0-0 0-0-1 0-0-0 0-0-2 0-0-1 0-0-1 0-0-0 0-0-1 0-0-0 0-0-1 0-0-0 0-0-2 0-0-0 0-0-1 0-1-2 
0-1-1 0-0-0 0-0-1 0-0-2 0-0-1 0-0-0 0-0-2 0-0-2 0-0-2 0-0-0 0-0-2 0-0-2 0-0-2 0-0-2 0-0-0 0-0-2 0-0-1 0-0-2 0-0-0 0-0-1 0-0-1 0-0-2 0-0-1 0-0-2 0-0-0 0-0-2 0-0-0 0-0-2 0-0-1 0-0-1 0-0-2 0-0-2 0-0-0 0-0-0 0-0-0 0-0-0 0-0-1 0-0-0 0-0-0 0-1-2 
0-1-0 0-1-0 0-1-0 0-1-2 0-1-1 0-1-0 0-1-1 0-1-1 0-1-1 0-1-2 0-1-0 0-1-0 0-1-2 0-1-0 0-1-0 0-1-2 0-1-1 0-1-0 0-1-2 0-1-1 0-1-0 0-1-2 0-1-2 0-1-0 0-1-2 0-1-0 0-1-0 0-1-1 0-1-2 0-1-2 0-1-2 0-1-1 0-1-1 0-1-0 0-1-2 0-1-0 0-1-2 0-1-0 0-1-0 0-1-1 
END
PLAYER SWORDSMAN
ENEMY 23 19 2 ARCHER
ENEMY 32 27 2 ARCHER
ENEMY 9 27 2 ARCHER
ENEMY 32 21 2 ARCHER
ENEMY 29 9 2 ARCHER
ENEMY 18 14 2 ARCHER
ENEMY 19 27 2 ARCHER
ENEMY 2 27 0 ARCHER
ENEMY 2 4 0 ARCHER
ENEMY 37 8 0 ARCHER
PATROLPATH 29 9 -d 23 14 -d 24 5 -t 1 
PATROLPATH 18 4 -d 18 14 -d 9 20 -t 1 
PATROLPATH 37 27 -d 19 27 -d 33 15 -t 1 
PATROLPATH 32 27 -d 32 21 -t 1 
PATROLPATH 27 20 -d 27 12 -d 33 15 -t 1 
PATROLPATH 24 5 -d 24 2 -t 100 -a 90 
PATROLPATH 33 15 -d 37 8 -t 1 
PATROLPATH 2 27 -d 2 20 -t 1 
PATROLPATH 37 8 -d 37 27 -d 32 21 -t 1 
PATROLPATH 32 21 -d 27 20 -d 33 15 -d 19 23 -t 1 
PATROLPATH 9 20 -d 8 4 -d 2 20 -t 1 
PATROLPATH 2 20 -d 9 20 -d 2 4 -t 1 
PATROLPATH 23 14 -d 23 19 -d 24 5 -t 1 
PATROLPATH 24 2 -d 8 4 -t 100 
PATROLPATH 23 19 -d 19 23 -d 27 20 -t 1 
PATROLPATH 9 27 -d 9 23 -d 2 27 -t 1 
PATROLPATH 18 14 -d 23 14 -d 23 19 -t 1 
PATROLPATH 27 12 -d 29 9 -t 1 
PATROLPATH 19 27 -d 32 27 -d 9 27 -t 1 
PATROLPATH 9 23 -d 9 20 -d 9 27 -t 1 
PATROLPATH 19 23 -d 19 27 -d 9 23 -t 1 
PATROLPATH 2 4 -d 8 4 -t 1 
PATROLPATH 8 4 -d 18 4 -t 1 
TRAP 37 6 0 -k 3 
TRAP 38 6 0 -k 3 
ITEM 20 2 6
ITEM 1 28 3
