30 40
0-1-2 0-1-1 0-1-0 0-1-2 0-1-1 0-1-0 0-1-1 0-1-1 0-1-2 0-1-1 0-1-1 0-1-0 0-1-2 0-1-0 0-1-1 0-1-2 0-1-0 0-1-2 0-1-2 0-1-2 0-1-2 0-1-0 0-1-2 0-1-2 0-1-2 0-1-2 0-1-0 0-1-0 0-1-1 0-1-0 0-1-0 0-1-1 0-1-1 0-1-0 0-1-0 0-1-2 0-1-2 0-1-0 0-1-0 0-1-2 
0-1-2 0-8-0 0-8-1 0-8-2 0-8-2 0-8-0 0-8-1 0-8-1 0-8-2 0-8-2 0-8-1 0-8-2 0-8-0 0-8-2 0-8-0 0-8-0 0-8-0 0-8-0 0-8-1 0-8-2 0-8-1 0-8-2 0-8-1 0-8-2 0-8-0 0-8-2 0-8-2 0-8-2 0-8-2 0-8-2 0-8-2 0-8-2 0-8-0 0-8-1 0-8-1 0-8-1 0-8-1 0-8-0 0-8-0 0-1-1 
0-1-0 0-8-2 0-8-2 0-8-2 0-8-0 0-8-0 0-8-2 0-8-0 0-8-0 0-8-1 0-8-2 0-8-2 0-8-1 0-8-1 0-8-0 0-8-1 0-8-2 0-8-1 0-8-1 0-8-2 0-8-2 0-1-2 0-1-0 0-1-1 0-1-1 0-1-2 0-1-2 0-1-2 0-1-1 0-8-2 0-8-1 0-8-2 0-8-2 0-8-1 0-8-1 0-8-0 0-8-0 0-8-0 0-8-2 0-1-1 
0-1-1 0-8-2 0-8-1 0-8-0 0-8-2 0-8-0 0-8-0 0-8-0 0-8-1 0-8-1 0-8-1 0-8-2 0-8-0 0-8-0 0-8-2 0-8-2 0-8-1 0-8-1 0-8-0 0-8-0 0-8-0 0-1-1 0-0-2 0-0-2 0-0-1 0-0-2 0-0-1 0-0-0 0-1-0 0-8-2 0-8-0 0-8-2 0-8-0 0-8-1 0-8-2 0-8-2 0-8-2 0-8-0 0-8-0 0-1-1 
0-1-2 0-8-0 0-8-1 0-8-2 0-8-2 0-8-1 0-8-0 0-8-0 0-8-1 0-8-0 0-8-0 0-8-1 0-8-2 0-8-0 0-8-0 0-8-2 0-8-0 0-8-2 0-8-2 0-8-2 0-8-2 0-1-2 0-0-2 0-0-2 0-0-1 0-0-0 0-0-0 0-0-1 0-1-2 0-8-1 0-8-2 0-8-0 0-8-1 0-8-1 0-8-2 0-8-0 0-8-1 0-8-0 0-8-2 0-1-2 
0-1-2 0-8-0 0-8-1 0-8-2 0-8-2 0-8-0 0-8-0 0-8-2 0-8-1 0-8-0 0-8-2 0-8-2 0-8-2 0-8-2 0-8-2 0-8-2 0-8-0 0-8-2 0-8-0 0-8-1 0-8-2 0-1-2 0-0-2 0-1-0 0-1-1 0-1-2 0-1-0 0-1-1 0-1-0 0-8-1 0-8-0 0-8-2 0-8-0 0-8-1 0-8-1 0-8-2 0-8-2 0-8-0 0-8-0 0-1-1 
0-1-2 0-8-0 0-8-2 0-8-2 0-8-1 0-8-0 0-1-2 0-1-0 0-1-0 0-1-1 0-1-1 0-1-2 0-1-1 0-1-0 0-1-0 0-1-0 0-1-1 0-1-1 0-1-0 0-1-2 0-1-0 0-1-1 0-0-0 0-1-1 0-8-2 0-8-0 0-8-2 0-8-1 0-8-2 0-8-2 0-8-0 0-8-2 0-8-1 0-8-0 0-8-2 0-8-0 0-8-1 0-8-2 0-8-0 0-1-2 
0-1-0 0-8-2 0-8-0 0-8-0 0-8-2 0-8-1 0-1-2 0-0-1 0-0-1 0-0-2 0-0-1 0-0-0 0-0-2 0-0-0 0-0-0 0-0-1 0-0-0 0-0-2 0-0-1 0-0-2 0-0-2 0-0-0 0-0-2 0-1-2 0-8-0 0-8-0 0-8-1 0-8-2 0-8-2 0-8-0 0-8-2 0-8-2 0-8-0 0-8-0 0-8-0 0-8-0 0-8-2 0-8-2 0-8-1 0-1-1 
0-1-1 0-1-2 0-1-0 0-1-1 0-1-2 0-1-1 0-1-2 0-0-1 0-1-0 0-1-1 0-1-2 0-1-1 0-1-1 0-1-2 0-1-0 0-0-1 0-0-0 0-0-1 0-0-1 0-0-1 0-1-2 0-1-0 0-1-0 0-1-2 0-8-2 0-8-0 0-8-2 0-8-0 0-8-1 0-8-1 0-8-0 0-8-2 0-8-0 0-8-0 0-8-1 0-8-1 0-8-0 0-8-2 0-8-2 0-1-0 
0-1-0 0-1-1 0-0-2 0-0-0 0-0-2 0-0-2 0-1-2 0-0-2 0-1-2 0-8-2 0-8-0 0-8-1 0-8-0 0-8-2 0-1-0 0-0-1 0-0-1 0-0-2 0-0-0 0-0-0 0-1-2 0-8-1 0-8-0 0-8-0 0-8-0 0-8-1 0-8-0 0-8-1 0-8-2 0-8-1 0-8-2 0-8-2 0-8-1 0-8-2 0-8-0 0-8-0 0-8-2 0-8-0 0-8-2 0-1-0 
0-1-1 0-1-0 0-0-1 0-0-0 0-1-2 0-0-2 0-1-1 0-0-0 0-1-1 0-8-0 0-8-1 0-8-0 0-8-0 0-8-1 0-1-1 0-0-0 0-0-2 0-0-0 0-0-0 0-0-2 0-1-0 0-8-0 0-8-0 0-1-0 0-1-1 0-1-0 0-1-2 0-1-1 0-1-0 0-1-1 0-8-0 0-8-2 0-8-0 0-8-1 0-8-1 0-8-1 0-8-1 0-8-2 0-8-0 0-1-1 
0-1-1 0-1-1 0-0-2 0-0-0 0-1-2 0-0-0 0-0-1 0-0-0 0-1-0 0-8-1 0-8-0 0-8-1 0-8-0 0-8-2 0-1-1 0-0-1 0-0-2 0-0-1 0-0-0 0-0-2 0-1-2 0-1-2 0-1-2 0-1-1 0-0-1 0-0-0 0-0-2 0-0-1 0-0-1 0-1-0 0-8-0 0-8-1 0-8-0 0-8-2 0-8-2 0-8-2 0-8-2 0-8-0 0-8-2 0-1-2 
0-1-1 0-1-0 0-2-0 0-0-2 0-1-0 0-1-1 0-1-0 0-1-0 0-1-2 0-8-0 0-8-0 0-8-1 0-8-2 0-8-1 0-1-2 0-0-1 0-0-0 0-0-1 0-0-0 0-0-0 0-0-1 0-0-2 0-0-2 0-0-0 0-0-1 0-0-2 0-0-0 0-0-2 0-0-1 0-1-1 0-8-2 0-8-2 0-8-2 0-8-1 0-8-0 0-8-2 0-8-0 0-8-2 0-8-2 0-1-0 
0-1-0 0-1-0 0-0-2 0-0-1 0-1-1 0-8-2 0-8-0 0-8-0 0-8-1 0-8-0 0-8-1 0-8-1 0-8-0 0-8-2 0-1-1 0-0-2 0-0-0 0-0-0 0-0-2 0-0-0 0-0-0 0-0-2 0-0-1 0-0-0 0-0-2 0-0-1 0-0-2 0-0-1 0-0-1 0-1-1 0-8-1 0-8-2 0-8-1 0-8-0 0-8-2 0-8-1 0-8-1 0-8-1 0-8-0 0-1-2 
0-1-2 0-1-0 0-0-2 0-0-0 0-1-0 0-8-2 0-8-2 0-8-0 0-8-2 0-8-2 0-8-0 0-8-2 0-8-2 0-8-1 0-1-1 0-0-2 0-0-2 0-0-1 0-0-1 0-0-0 0-0-0 0-1-0 0-1-2 0-1-1 0-0-0 0-0-0 0-0-0 0-0-1 0-0-0 0-1-2 0-8-2 0-8-0 0-8-0 0-8-0 0-8-0 0-8-2 0-8-0 0-8-0 0-8-0 0-1-2 
0-1-1 0-1-2 0-0-0 0-0-1 0-1-0 0-8-2 0-8-1 0-8-2 0-1-0 0-1-1 0-1-2 0-1-1 0-8-2 0-8-0 0-1-1 0-0-0 0-1-0 0-1-0 0-1-1 0-0-2 0-0-0 0-1-0 0-8-1 0-1-1 0-0-0 0-0-0 0-0-2 0-0-0 0-0-0 0-1-2 0-8-1 0-8-0 0-8-2 0-8-2 0-8-1 0-8-2 0-8-0 0-8-0 0-8-1 0-1-0 
0-1-0 0-1-1 0-0-1 0-0-1 0-1-0 0-8-2 0-8-2 0-8-2 0-1-1 0-0-0 0-0-1 0-1-1 0-1-2 0-1-1 0-1-2 0-0-2 0-1-2 0-8-0 0-1-0 0-0-0 0-0-0 0-1-0 0-8-0 0-1-2 0-0-0 0-0-1 0-0-1 0-0-1 0-0-0 0-1-2 0-8-0 0-8-2 0-8-1 0-8-1 0-8-2 0-8-0 0-8-2 0-8-2 0-8-0 0-1-0 
0-1-2 0-8-2 0-8-1 0-8-0 0-8-1 0-8-0 0-8-1 0-8-0 0-1-2 0-0-2 0-0-0 0-0-2 0-0-1 0-0-0 0-0-2 0-0-2 0-1-2 0-8-2 0-1-2 0-0-2 0-0-1 0-1-0 0-8-0 0-1-2 0-0-1 0-0-2 0-0-2 0-0-1 0-0-2 0-1-0 0-8-0 0-8-0 0-8-2 0-8-1 0-8-0 0-8-2 0-8-2 0-8-0 0-8-1 0-1-2 
0-1-2 0-1-0 0-1-1 0-1-1 0-1-1 0-1-1 0-1-0 0-1-0 0-1-0 0-1-0 0-1-2 0-1-2 0-1-2 0-1-0 0-1-2 0-1-1 0-1-0 0-1-2 0-1-1 0-0-0 0-0-2 0-1-2 0-1-2 0-1-2 0-1-0 0-1-1 0-1-1 0-1-0 0-1-1 0-1-1 0-1-1 0-1-2 0-1-1 0-1-0 0-1-2 0-1-0 0-1-0 0-1-1 0-1-0 0-1-0 
1-0-0 1-0-2 1-0-2 1-0-0 1-0-1 1-0-0 1-0-1 1-0-1 1-0-0 1-0-2 1-0-2 1-0-0 1-0-0 1-0-0 1-0-2 1-0-2 1-0-1 1-0-1 1-0-1 1-0-0 1-0-1 1-0-1 1-0-2 1-0-0 1-0-2 1-0-1 1-0-0 1-0-0 1-0-0 1-0-1 1-0-1 1-0-2 1-0-1 1-0-2 1-0-1 1-0-1 1-0-0 1-0-0 1-0-0 1-0-1 
1-0-2 1-0-0 1-0-2 1-0-2 1-0-0 1-0-2 1-0-1 1-0-0 1-0-2 1-0-0 1-0-2 1-0-0 1-0-2 1-0-2 1-0-0 1-0-2 1-0-1 1-0-1 1-0-0 1-0-0 1-0-2 1-0-0 1-0-1 1-0-1 1-0-2 1-0-0 1-0-2 1-0-2 1-0-1 1-0-2 1-0-1 1-0-2 1-0-1 1-0-1 1-0-0 1-0-1 1-0-0 1-0-0 1-0-0 1-0-1 
1-0-1 1-0-2 1-0-1 1-0-2 1-0-2 1-0-2 1-0-0 1-0-1 1-0-0 1-0-0 1-0-0 1-0-2 1-0-0 1-0-2 1-0-2 1-0-0 1-0-2 1-0-1 1-0-2 1-0-0 1-0-0 1-0-1 1-0-2 1-0-2 1-0-1 1-0-2 1-0-1 1-0-0 1-0-1 1-0-0 1-0-0 1-0-2 1-0-1 1-0-0 1-0-2 1-0-1 1-0-2 1-0-2 1-0-2 1-0-0 
1-1-1 1-1-0 1-1-1 1-1-2 1-1-1 1-1-0 1-1-0 1-1-1 1-1-0 1-1-2 1-1-1 1-1-2 1-1-1 1-1-2 1-1-2 1-1-2 1-1-0 1-1-1 1-0-0 1-0-1 1-0-1 1-1-1 1-1-1 1-1-1 1-1-1 1-1-2 1-1-0 1-1-0 1-1-0 1-1-2 1-1-1 1-1-1 1-1-2 1-1-1 1-1-1 1-1-0 1-1-1 1-1-2 1-1-1 1-1-1 
1-1-2 1-1-2 1-1-2 1-1-1 1-1-0 1-1-1 1-1-2 1-1-2 1-1-1 1-1-0 1-1-1 1-1-0 1-1-1 1-1-1 1-1-2 1-1-0 1-1-1 1-1-2 1-0-2 1-0-0 1-0-0 1-1-1 1-1-2 1-1-0 1-1-1 1-1-0 1-1-0 1-1-0 1-1-1 1-1-1 1-1-1 1-1-2 1-1-0 1-1-0 1-1-0 1-1-2 1-1-2 1-1-2 1-1-1 1-1-0 
1-1-1 1-1-2 1-1-2 1-1-2 1-1-2 1-1-0 1-1-1 1-0-2 1-0-2 1-0-1 1-0-1 1-0-2 1-0-2 1-0-1 1-0-0 1-0-1 1-0-2 1-0-2 1-0-2 1-0-2 1-0-0 1-0-0 1-0-1 1-0-1 1-0-0 1-0-0 1-0-0 1-0-2 1-0-2 1-0-2 1-0-0 1-0-0 1-0-2 1-0-2 1-0-2 1-0-1 1-0-0 1-0-2 1-0-0 1-0-1 
1-0-1 1-0-1 1-0-0 1-0-1 1-0-1 1-0-1 1-0-1 1-0-0 1-0-2 1-0-1 1-0-1 1-0-0 1-0-1 1-0-0 1-0-0 1-0-0 1-0-1 1-0-2 1-0-2 1-0-1 1-0-1 1-0-2 1-0-2 1-0-1 1-0-2 1-0-1 1-0-2 1-0-0 1-0-2 1-0-1 1-0-1 1-0-1 1-0-1 1-0-2 1-0-0 1-0-1 1-0-2 1-0-1 1-0-1 1-0-2 
1-0-2 1-0-2 1-0-0 1-0-2 1-0-2 1-0-1 1-0-2 1-0-0 1-0-0 1-0-0 1-0-1 1-0-0 1-0-0 1-0-1 1-0-0 1-0-0 1-0-1 1-0-0 1-0-1 1-0-1 1-0-1 1-0-0 1-0-2 1-0-2 1-0-2 1-0-1 1-0-1 1-0-2 1-0-2 1-0-2 1-0-0 1-0-0 1-0-2 1-0-0 1-0-1 1-0-0 1-0-2 1-0-1 1-0-1 1-0-2 
1-0-1 1-0-0 1-0-1 1-0-0 1-0-1 1-0-0 1-1-0 1-1-0 1-1-0 1-1-1 1-1-1 1-1-0 1-1-2 1-1-2 1-1-2 1-1-1 1-1-1 1-1-0 1-0-0 1-0-0 1-0-2 1-1-1 1-1-0 1-1-2 1-1-1 1-1-2 1-1-0 1-1-2 1-1-2 1-1-2 1-1-1 1-1-0 1-1-1 1-1-2 1-1-2 1-1-1 1-0-2 1-0-0 1-0-1 1-0-0 
1-0-2 1-0-1 1-0-0 1-0-1 1-1-0 1-1-1 1-1-1 1-1-2 1-1-2 1-1-2 1-1-2 1-1-2 1-1-2 1-1-2 1-1-2 1-1-2 1-1-2 1-1-2 1-4-1 1-4-2 1-4-0 1-1-1 1-1-1 1-1-1 1-1-1 1-1-1 1-1-1 1-1-1 1-1-1 1-1-1 1-1-1 1-1-1 1-1-1 1-1-1 1-1-1 1-1-0 1-1-1 1-1-0 1-1-1 1-1-2 
1-0-1 1-0-1 1-0-1 1-0-0 1-1-0 1-1-2 1-1-2 1-1-2 1-1-2 1-1-2 1-1-2 1-1-2 1-1-2 1-1-2 1-1-2 1-1-2 1-1-2 1-1-2 1-4-2 1-4-1 1-4-0 1-1-0 1-1-1 1-1-1 1-1-1 1-1-1 1-1-1 1-1-1 1-1-1 1-1-1 1-1-1 1-1-1 1-1-1 1-1-1 1-1-1 1-1-1 1-1-1 1-1-1 1-1-1 1-1-1 
END
PLAYER SWORDSMAN
ENEMY 22 20 0 ARCHER
ENEMY 28 16 0 ARCHER
ENEMY 15 25 0 ARCHER
ENEMY 5 25 0 ARCHER
ENEMY 27 25 0 ARCHER
ENEMY 37 20 0 ARCHER
ENEMY 37 25 0 ARCHER
ENEMY 5 20 0 ARCHER
ENEMY 26 4 0 ARCHER
ENEMY 16 20 0 ARCHER
ENEMY 26 16 0 ARCHER
PATROLPATH 8 25 -d 15 25 -t 80 -a 180 
PATROLPATH 22 20 -d 30 20 -t 40 -a 180 
PATROLPATH 27 25 -d 33 25 -t 40 -a 180 
PATROLPATH 33 25 -d 27 25 -t 80 -a 0 
PATROLPATH 15 25 -d 8 25 -t 40 -a 0 
PATROLPATH 5 25 -t 100 -a 0 
PATROLPATH 30 20 -d 22 20 -t 80 -a 0 
PATROLPATH 28 16 -t 100 -a 180 
PATROLPATH 5 20 -t 100 -a 0 
PATROLPATH 8 20 -d 16 20 -t 80 -a 180 
PATROLPATH 37 25 -t 100 -a 180 
PATROLPATH 37 20 -t 100 -a 180 
PATROLPATH 26 4 -t 100 -a 180 
PATROLPATH 16 20 -d 8 20 -t 40 -a 0 
PATROLPATH 26 16 -d 21 13 -t 60 -a 0 
PATROLPATH 21 13 -d 26 16 -t 200 -a 180 
TRAPTRIGGER 13 14 -d 13 14 -d 13 14 -d 13 14 -d 13 14 -d 13 14 -d 15 16 -t 1 
TRAPTRIGGER 12 15 -d 12 15 -d 12 15 -d 12 15 -d 12 15 -d 12 15 -d 12 17 -t 1 
TRAPTRIGGER 13 15 -d 13 15 -d 13 15 -d 13 15 -d 13 15 -d 13 15 -d 14 17 -t 1 
TRAP 2 16 0 -k 0 
TRAP 19 18 0 -k 3 
TRAP 13 14 4 -t 20 
TRAP 13 15 4 -t 20 
TRAP 14 17 3  
TRAP 23 12 0 -k 0 
TRAP 12 17 3  
TRAP 3 16 0 -k 0 
TRAP 20 18 0 -k 3 
TRAP 23 13 0 -k 0 
TRAP 15 16 3  
TRAP 12 15 4 -t 20 
ITEM 9 16 6
ITEM 27 3 3
